NO   ./texteurs/wall.xpm
SO   ./texteurs/wall.xpm
WE ./texteurs/floor.xpm
EA ./texteurs/floor.xpm
F  192 , 192 ,192
C 51,25,0


        1111111111111111111111111
        1E000000000110000000000001
        1011000001110000000000001
        1001000000000000000000001
111111111011000001110000000000001
100000000011000001110111111111111
1111011111111101111000001000111
11110111111111011101010010001
11000000110101011 100000000001
10000000000000001100000010001
10000000000000001101010010001
110000011101010111110111100111
11110111 1110101 101111010001
11111111 1111111 111111111111
