NO   ./texteurs/NO.xpm
SO   ./texteurs/SO.xpm
WE   ./texteurs/WE.xpm
EA ./texteurs/EA.xpm
F  224 , 224 ,224
C 51,25,0


        1111111111111111111111111
        1E0000000000000000000001
        101000000010000000000001
        1001000000D00000001000001
11111111101100000010000000D000001
10000000001100000000000011111111
111101111111110111100000000111
11110111111111011101010010001
11000000000000011 100000000001
10000000000000001100000010001
1000000000000001101010010001
110000011101010111110111100111
11110111 1110101 101111010001
11111111 1111111 111111111111
